11111111111111111111111111111111111111111111111111111111
10000000000000000000000000000000000C0000000000000C0C0C01
1000000000000000000E0000000000000000000000C00000000000C1
100000000000P0000000000000000000000000000000C00000000001
10000001111111111111111110000000000000101011111111110001
10000000000000000000000000000111111111100000000100000001
1000000000111111111111111111CC11111111111111111111111111
11111111111111111111111111111111111111111111111111111111