111111111111111
1P000C0000000E1
111111111111111