1111111111111111111111111
10V0000000C00000000000001
1001111100000000111111101
1000V00000000000100000101
10011111000E0000000C00001
1000110000000000100V00101
1111111111000000111111101
1P00000000000000000000001
1111111111111111111111111