1111111111111
10V0000000C11
1000001111111
10010000000C1
1000011111001
1P0011E000001
1111111111001
100000V000001
1111111111111
