111111111111111111
111111100000000001
110000000000000111
10000000E000000P01
111111111111111111