11111111111
1111C111111
11P111111E1
11111111111
